 ,B,S, , ,<,
+, , , , , ,
 , ,X, , ,A,
B,S,|, , ,v,
 , , ,A, , ,
 ,v,S, , ,<,
 ,>, ,^, , ,