 , , , , , ,
 , , , , , ,
 , , , ,A, ,
X,B, , ,+,|,
.,X, , ,B, ,
X, , , , , ,
*, , , ,A, ,
9 9 9 9 9