.,A,X, , , ,
X,X, , , , ,
B,X, , , ,A,
 , , , , , ,X
+, , ,X, ,X,
 , ,X, , ,B,
*, ,X, , , ,
1 1 1 1 2