 ,X, , , , ,
 ,X, , , , ,
.,X, , , , ,
 ,X, , ,+, ,
 ,X, , , , ,
 , , , , , ,
*, , , , , ,
1 0 0 1 0