 , , , ,X,.,X
 , , , , ,X,
 , , , , , ,
 , , , , ,X,
 , , , , , ,
 , , , ,+, ,
*, , ,X, , ,
1 0 2 4 0