B, , , , ,B,
 , , , , , ,
 , , , , ,X,X
., , , ,A, ,
 , , , , ,X,X
X,X,X,X, , ,
*, , ,A, , ,
1 1 1 1 1