.,X,B, ,+, ,
X,X,X,X,X, ,
 , , ,X, , ,
 ,B,A,X,X,X,X
 , , , , , ,
X,X,X,X,X,A,
*, , , , , ,
1 0 1 2 1